Map10
1 1 G 1 1 1 1 S 1 1 
1 0 F 0 F 0 0 0 0 1 
1 0 0 0 0 0 0 1 1 1 
1 H 0 0 F 0 0 0 0 1 
1 F 0 0 0 0 0 0 0 1 
1 0 F F 0 0 1 # 0 1 
1 # 0 0 0 1 # 0 0 1 
1 # 0 0 0 0 F 0 # 1 
1 H H 0 1 0 0 0 # 1 
1 1 1 1 1 1 1 1 1 1 
P51 p37 T10

Map10
1 1 1 1 1 1 1 1 1 1 
1 1 1 G 1 1 1 1 1 1 
1 # 0 0 1 0 0 0 1 1 
1 1 0 # 0 0 0 # 1 1 
1 1 0 H 0 0 0 0 1 1 
S 0 0 H 0 0 0 # 1 1 
1 0 1 0 0 0 0 0 1 1 
1 0 # 1 1 0 # 0 1 1 
1 1 0 0 # # 0 0 1 1 
1 1 1 1 1 1 1 1 1 1 
P72 P25 T10

Map10
1 1 1 1 1 1 1 1 1 1 
G 0 1 H 0 0 0 0 0 1 
1 0 0 0 0 0 # 0 0 1 
1 0 0 0 0 0 0 H 1 1 
1 H 0 F 0 H 0 0 0 1 
1 H 0 0 H 0 0 # 0 1 
1 0 1 # # 0 0 0 # 1 
S F 0 0 F H 0 1 0 1 
1 0 0 0 0 0 0 0 1 1 
1 1 1 1 1 1 1 1 1 1 
P37 p58 T10

Map10
1 1 1 1 1 G 1 1 1 1 
1 0 H # 1 0 0 # 1 1 
1 1 F 0 1 0 1 F 0 1 
1 0 H F 0 H 0 0 0 1 
1 0 0 0 0 0 0 1 H 1 
1 0 0 0 1 0 H F 0 1 
1 0 0 0 H 0 F 1 0 1 
S 0 # F F 0 0 0 0 1 
1 0 0 0 0 0 0 0 0 1 
1 1 1 1 1 1 1 1 1 1 
P13 p63 T11

Map10
1 1 1 1 1 1 1 1 1 1 
1 H 0 0 1 0 F 0 1 1 
1 0 # 0 0 0 # 0 1 1 
1 # F 1 0 0 1 0 1 1 
1 H 1 # 0 1 0 0 1 1 
1 0 0 1 0 0 1 0 1 1 
1 0 0 0 0 1 0 0 S 1 
1 H F 0 0 H 0 H 1 1 
1 1 G 1 1 1 1 1 1 1 
1 1 1 1 1 1 1 1 1 1 
P16 p45 T10

Map10
1 1 1 1 1 1 1 1 1 1 
1 1 1 1 1 1 1 1 1 1 
1 0 0 0 # 0 1 1 1 1 
S 0 H # 0 H 0 0 G 1 
1 0 0 0 0 1 0 0 1 1 
1 0 0 1 1 0 0 0 1 1 
1 0 1 1 0 0 0 0 1 1 
1 F 0 H 0 1 F F 1 1 
1 0 F 0 F 0 F 0 1 1 
1 1 1 1 1 1 1 1 1 1 
P52 U14 T10

Map10
1 1 1 1 1 1 1 1 1 1 
1 G 0 0 H 0 1 0 0 1 
1 1 0 1 0 0 0 H 0 1 
1 1 # 0 0 1 0 0 0 1 
1 1 1 H 1 0 H 0 0 1 
1 1 0 0 0 0 0 F 0 1 
1 1 0 0 0 # 0 0 0 1 
1 1 0 0 1 1 # 0 0 1 
1 1 1 S 1 1 1 1 1 1 
1 1 1 1 1 1 1 1 1 1 
P82 P35 T10

Map10
1 1 1 1 1 1 1 1 1 1 
1 1 H 0 0 0 0 F 0 1 
1 0 F # 1 F 0 0 0 1 
S 0 0 1 0 0 1 0 0 1 
1 0 H 0 0 # 0 F 0 1 
1 F 0 0 0 0 0 # 0 1 
1 1 # # # 0 0 0 0 1 
G # 0 0 1 # F 0 0 1 
1 F 0 F 1 1 0 H 0 1 
1 1 1 1 1 1 1 1 1 1 
P87 P28 T10

Map10
1 1 1 1 1 1 1 1 1 1 
1 1 1 1 1 S 1 1 1 1 
1 # 0 0 F 0 0 0 1 1 
1 H 0 0 0 0 1 0 1 1 
1 0 0 0 H H 1 0 1 1 
1 0 0 1 0 0 0 1 1 1 
1 1 0 0 0 0 0 0 1 1 
G 0 0 0 0 F 0 1 1 1 
1 0 0 F 0 0 0 H 1 1 
1 1 1 1 1 1 1 1 1 1 
P22 P53 T10

Map10
1 1 1 1 S 1 G 1 1 1 
1 0 0 0 0 1 0 # 0 1 
1 0 0 0 1 0 0 F 0 1 
1 0 0 0 0 0 0 F H 1 
1 0 0 H 0 0 0 F 0 1 
1 0 0 H F 0 1 0 F 1 
1 0 0 1 0 1 0 F 0 1 
1 0 0 0 F 0 H 0 F 1 
1 0 1 1 0 0 0 0 F 1 
1 1 1 1 1 1 1 1 1 1 
P63 p12 T10

Map10//notbad
1 1 1 1 1 S 1 1 1 1 
1 0 0 # 0 # 0 0 F 1 
1 1 F 0 0 0 0 0 0 1 
G 0 0 1 1 0 1 0 F 1 
1 0 # # 0 1 0 # F 1 
1 0 # 0 # 0 0 H 0 1 
1 1 H F 1 H 1 H 0 1 
1 0 0 0 0 0 0 0 0 1 
1 0 F 0 0 0 0 0 0 1 
1 1 1 1 1 1 1 1 1 1 
P53 P47 T10

Map10//notworse
1 1 1 1 S 1 G 1 1 1 
1 0 # 0 F F 0 H 0 1 
1 0 0 F 0 H 0 # 0 1 
1 0 0 0 0 1 0 0 0 1 
1 0 1 0 0 # F 1 # 1 
1 0 0 0 1 H 1 0 0 1 
1 F 0 # # 0 0 0 1 1 
1 0 # # 0 0 0 0 H 1 
1 0 0 0 0 0 1 1 1 1 
1 1 1 1 1 1 1 1 1 1 
P82 P15 T11

Map10
1 1 1 G 1 1 1 1 1 1 
S 0 1 0 0 0 0 F 0 1 
1 0 # H 0 0 0 1 0 1 
1 0 0 0 H 0 H 0 0 1 
1 1 0 0 0 0 0 0 1 1 
1 0 0 0 0 # F 0 0 1 
1 H # 0 F 0 H H 0 1 
1 0 0 0 0 F 0 0 H 1 
1 0 0 1 F F # 0 1 1 
1 1 1 1 1 1 1 1 1 1 
P33 P25 T10