Level73//removed decent maps
1 1 S 1 1 1 1 1 
1 0 0 0 0 1 0 1 
1 # 0 0 0 0 0 1 
1 0 0 0 1 0 0 1 
1 # 0 0 0 F # 1 
1 1 0 1 0 1 0 1 
1 0 H F 0 1 0 1 
1 1 1 1 G 1 1 1 
P34 P65 R11 T6

Level77//fix or bye
1 1 1 1 1 1 1 1 
1 1 0 0 0 0 0 1 
1 1 1 0 1 0 0 S 
1 1 # H 0 0 0 1 
1 1 0 H 0 F # G 
1 1 1 0 H 0 # 1 
1 1 1 1 1 1 1 1 
1 1 1 1 1 1 1 1 
U63 D41 T6

Level89//too easy
1 1 1 1 1 1 1 1 
1 1 1 1 1 1 1 1 
1 1 0 1 0 F 1 1 
1 1 F 0 0 0 G 1 
1 1 0 0 0 0 S 1 
1 1 1 0 F 1 1 1 
1 1 1 1 1 1 1 1 
1 1 1 1 1 1 1 1 
p44 T4

Level103//putearlier or BYE
1 1 1 1 1 1 1 1 
1 1 1 1 1 1 1 1 
1 1 0 1 0 0 # G 
1 1 # 0 0 0 H 1 
1 1 # H 1 0 # 1 
1 1 0 0 0 0 1 1 
1 1 # 0 # 0 # 1 
1 1 S 1 1 1 1 1 
p36 T8

Level108//gud but earlierpls, even fixable
1 1 1 1 1 1 1 1 
1 0 0 1 1 0 0 1 
1 1 # 0 0 # 0 1 
1 0 F 0 1 1 0 1 
1 F 1 F 0 1 0 1 
1 0 0 0 0 0 # 1 
1 0 0 0 0 F 0 1 
1 S 1 1 1 G 1 1 
p45 P36 T6

Level122//extragood, last one?
1 1 1 1 G 1 1 1 1 1 
1 1 0 F F F # 0 0 1 
1 1 0 1 0 0 0 0 0 1 
1 1 0 0 H 0 0 F F 1 
1 1 # 0 0 0 0 1 0 1 
1 1 0 0 0 F 0 F H 1 
1 1 0 F 0 0 F 1 1 1 
1 1 0 0 1 0 0 0 F 1 
1 1 S 1 1 1 1 1 1 1 
1 1 1 1 1 1 1 1 1 1 
p63 D25 T10

Level134//nope, adjacent y necesitaria mucho jale/
1 1 1 1 1 1 1 1 
1 1 1 1 1 1 1 1 
1 0 0 1 0 0 1 1 
1 0 # 0 0 0 1 1 
1 0 0 0 1 0 G 1 
1 0 # 1 0 0 S 1 
1 0 0 0 0 0 1 1 
1 1 1 1 1 1 1 1 
l53 T9

Level140// more moves
1 1 1 G 1 1 1 1 1 1 
S 0 # 0 0 0 0 # 0 1 
1 0 H F 0 0 F 0 0 1 
1 0 0 # 0 1 H H 0 1 
1 0 F F 0 # 0 1 H 1 
1 0 1 0 0 1 0 0 0 1 
1 0 0 F 0 # H 1 H 1 
1 0 0 0 1 # F 0 0 1 
1 0 F # 0 0 F 0 1 1 
1 1 1 1 1 1 1 1 1 1 
d41 T8

Level147//gut, liberty, nmm
1 1 1 1 1 S 1 1 1 1 
1 0 0 1 F 0 0 0 0 1 
1 F F # F 0 # F 0 1 
1 F 0 # 1 0 1 0 F 1 
1 0 1 0 0 # 0 0 0 1 
1 0 0 1 1 1 # 0 F 1 
G 0 # 0 0 0 0 0 H 1 
1 1 # # # # 0 # H 1 
1 0 F # # 0 F 0 1 1 
1 1 1 1 1 1 1 1 1 1 
d64 L76 T5

Level151
1 1 1 G 1 1 1 1 1 1 
1 0 0 0 0 0 H 0 0 1 
1 0 0 0 0 0 1 0 # 1 
1 1 0 0 # 0 0 F 0 1 
1 0 0 0 H # 0 0 0 1 
S 0 F 0 0 0 0 0 # 1 
1 0 0 0 0 F 0 0 0 1 
1 0 0 1 1 0 H 0 0 1 
1 H 0 0 0 H F 0 1 1 
1 1 1 1 1 1 1 1 1 1 
u35 T6

Level152
1 1 1 1 1 1 1 1 1 1 
1 0 0 0 0 0 0 0 0 1 
1 # # F 0 0 0 0 0 1 
1 # 1 F 0 0 0 0 F 1 
G 0 0 0 0 0 0 # 0 1 
1 # 0 # 0 0 0 0 0 1 
S # 0 0 0 1 0 0 1 1 
1 0 0 # 0 0 # 0 0 1 
1 0 0 0 0 F 0 # 0 1 
1 1 1 1 1 1 1 1 1 1 
u26 T6

Level154//hmmmmmmbye
1 1 1 1 S 1 1 1 1 1 
1 # 0 0 0 0 F 0 0 1 
1 0 0 1 # 1 0 # 1 1 
1 F 0 0 F # F F 0 1 
1 # 0 1 0 0 0 0 0 1 
1 # 0 0 0 0 F # 0 1 
G F 0 0 0 0 H 0 0 1 
1 0 0 1 F # F 1 0 1 
1 0 # 0 # 0 1 0 0 1 
1 1 1 1 1 1 1 1 1 1 
l56 d44 T5

Level161//meh
1 S 1 1 1 1 1 1 1 1 
1 0 0 0 0 0 0 # 1 1 
1 0 F 0 0 0 0 0 0 1 
1 0 0 0 0 0 0 0 0 1 
1 0 0 0 0 0 0 0 0 1 
1 0 0 0 H 0 0 0 0 1 
G 0 0 0 0 0 H 0 0 1 
1 0 0 # 0 0 0 1 F 1 
1 0 0 H F 0 0 0 H 1 
1 1 1 1 1 1 1 1 1 1 
d21 U15 T9

Level163//meh
1 1 1 1 1 1 G 1 1 1 
1 0 # # 0 F 0 0 0 1 
1 0 0 0 0 0 F # # 1 
1 0 0 1 0 1 0 # 0 1 
S # 0 0 0 0 1 0 0 1 
1 0 H 0 H 0 0 # 0 1 
1 H 0 0 # H 0 # 1 1 
1 0 0 1 0 0 0 0 0 1 
1 # # 0 0 0 0 # 0 1 
1 1 1 1 1 1 1 1 1 1 
l83 T9

Level158//earliest
1 1 1 1 1 1 1 1 1 1 
G 0 0 1 0 0 1 0 # 1 
1 0 F 0 # 0 0 F F 1 
1 F 0 1 0 F 0 0 # 1 
1 0 # F # 0 0 1 F 1 
1 0 0 0 0 1 0 0 0 1 
S 0 0 # 0 0 F 0 0 1 
1 0 1 0 0 0 0 0 F 1 
1 0 0 1 # 0 0 1 # 1 
1 1 1 1 1 1 1 1 1 1 
l56 T8

Level144//ez, add block, C/ remove?
1 1 1 1 1 1 1 1 1 1 
1 1 1 1 1 1 1 1 1 1 
G 0 0 # 0 H H F 1 1 
1 1 0 1 0 0 1 0 1 1 
1 0 0 0 F F 0 0 1 1 
S 0 0 0 0 0 F 0 1 1 
1 F F 0 0 0 0 F 1 1 
1 F 0 F 0 1 1 F 1 1 
1 F 1 0 0 0 0 0 1 1 
1 1 1 1 1 1 1 1 1 1 
u25 T6

Level141//bye?
1 1 1 1 1 1 1 1 
1 0 0 0 0 1 1 1 
1 1 F # 0 0 0 1 
G F 0 # 0 F 0 1 
1 0 0 0 # F 0 1 
1 0 1 # 0 0 0 1 
1 1 0 0 1 0 1 1 
1 1 1 1 1 S 1 1 
l43 T9

Level138///bye?
1 1 1 1 1 1 1 1 
1 0 0 F 1 # F 1 
1 0 0 0 0 0 0 1 
1 0 0 0 1 # F 1 
1 1 F 0 0 F 0 G 
1 # # 0 # 0 1 1 
1 1 0 0 0 # 0 1 
1 1 1 1 1 S 1 1 
r22 L66 T8