1 1 1 1 1 1 1 1 
1 # 0 0 F 0 1 1 
1 1 0 0 0 F 0 1 
1 1 0 0 0 # 0 1 
1 0 0 0 H # 0 1 
1 # 0 0 0 0 F 1 
S F 0 0 0 H F 1 
1 1 1 G 1 1 1 1
R23 U26 d33 